*** DIA 01: HTML & CSS - FORMS ***

<form action="" method="GET">
    <input type="text" name="texto">
    <button type="submit">Enviar</button>
</form>

Dentro da tag form:
    action: para onde vamos mandar os dados do formulário
    method: tipo de método que vamos usar(GET ou POST)
        método GET envia os dados por via da URL(endereço da página)
        método POST envia os dados de forma mais 'escondida' para outro ambiente sem ser pela URL

Dentro da tag input:
    type:
        button: define um botão;
        checkbox: permite que o usuário selecione ZERO ou MAIS opções de um número limitado de escolhas;
        color: campos de entrada que devem conter uma cor para selecionar;
        date: campos de entrada que devem conter uma data;
        datetime-local: campo de entrada de data e hora, sem fuso horário;
        email: campos de entrada que devem conter um endereço de e-mail;
        file: campo de seleção de arquivo e um botão "Procurar" para uploads de arquivos;
        month: permite ao usuário selecionar um mês e ano;
        number: define um campo de entrada numérico;
        password: os caracteres do campo de senha são mascarados (mostrados como asteriscos ou círculos);
        radio: permite que um usuário selecione APENAS UMA de um número limitado de opções;
        range: define um controle para inserir um número (como um controle deslizante). Intervalo padrão é de 0 a 100;
        reset: redefinirá todos os valores do formulário para seus valores padrão;
        search: usado para campos de pesquisa;
        submit: envia dados de formulário a um manipulador de formulários(especificado na action do form );
        tel: campos de entrada que devem conter um número de telefone;
        text: campo de entrada de texto de linha única;
        time: permite que o usuário selecione um horário (sem fuso horário);
        url: campos de entrada que devem conter um endereço URL;
        week: permite ao usuário selecionar uma semana e um ano.
    outros atributos:
        value: especifica um valor inicial para um campo de entrada;
        readonly: especifica que um campo de entrada é somente leitura;
        disabled: especifica que um campo de entrada deve ser desativado;
        size: especifica a largura visível, em caracteres, de um campo de entrada;
        maxlength: especifica o número máximo de caracteres permitidos em um campo de entrada;
        min e max: especificam os valores mínimo e máximo para um campo de entrada;
        multiple: especifica que o usuário tem permissão para inserir mais de um valor em um campo de entrada;
        pattern: especifica uma expressão regular em relação à qual o valor do campo de entrada é verificado;
        placeholder: especifica uma dica curta que descreve o valor esperado de um campo de entrada;
        required: especifica que um campo de entrada deve ser preenchido antes de enviar o formulário;
        step: especifica os intervalos de números válidos para um campo de entrada;
        autofocus: especifica que um campo de entrada deve obter foco automaticamente quando a página é carregada;
        height e width: especificam a altura e a largura de um elemento;
        autocomplete: especifica se um campo de entrada deve ter o preenchimento automático ativado ou desativado.

Dentro da tag label:
    for: recebe sempre o nome do id do imput que ele guarda

event.preventDefault(): evita o comportamento padrão do navegador sobre alguma ação disparada pelo evento

*** DIA 02: Bibliotecas JavaScript e Frameworks CSS ***

BIBLIOTECAS: são códigos reitilizáveis para diminuir problemas de compatibilidade em navegadores e para facilitar a uso da liguagem de programação
ex. moment.js - bom para trabalhar com datas, instala pelo npm e usa um require("nome da biblioteca") para usar abiblioteca
ex. cheet.js - têm vários easterEggs, importa o script pelo HTML

Bootstrap: é um framework CSS que ajuda a aplicar desing responsivo ao nosso site.
    getbootstrap.com - download do compiled CSS and JS - adicionar ele dentro da pasta onde está o projeto desejado
    o bootstrap exije a biblioteca JQuery (jquery.com) - download do arquivo dentro da pasta do projeto também
    o script do JQuery precisa ser declarado no HTML antes de script do bootstrap

*** DIA 03: Introdução e CSS Flexbox - Parte 1 ***

O flexbox é disponível no CSS, é aplicado na propriedade display.
É aplicado no container e em seus itens e serve para desenvolver um layout flexível, melhorando a dispozição dos itens no container pai.
Existem dois principais eixos no flexbox: o main axis (eixo principal) e o cross axis (eixo transversal). 
Eles controlam como os itens dentro do container flex ficam dispostos.

Main Axis: eixo horizoltal
Cros Axix: eixo vertical 